XXXXXXX
X  F  X
X     X
X    .X
XS    X
XXXXXXX